#####n#####
#         #
#     *   #
#         #
#         #
#         #
#    P    #
###########