###n###
#     #
#     #
# % m #
#     #
#  P  #
#######