###################################################
# #   # # # #     # #   #   # #           #   # # #
# # # # # # # ##### ### ### # # # # ####### ### # #
#   # # # # #   #     #   #   # # #     #       # #
##### # # # # ##### ### ### ####### ### # # ### # #
# #           # #   #         #       #   # # #   #
# # # ####### # ### # # # ### # ####### ### # #####
# # # # # # # # # #   # # # #   #   # #   #   #   #
# ##### # # # # # ### # # # ### ### # ### ### # ###
# # # #       #   #   # #     #     #   # # # # # #
# # # ##### ### # # ### ########### ### # # ### # #
# #   #     # # # #   #           #   # # #     # #
# # ##### # # # ### ### # ##### # ### # # # ##### #
# #     # # #         # # #   # # # #   #   #     #
# # # # ### # # # # # ### # # # # # # # ######### #
# # # # #   # # # # #   #   # # # # # # # #   # # #
# ### # ### ### # # # # # # # # ### ### # # ### # #
#     #   # #   # # # # # # # #     #   # #   # # #
####### ### # ##### ### # # # # # ### ### ### # # #
#             # #   #   # # # # #   #   #         #
### # ####### # # ### # ### ######### ######### # #
# # #     #     #   # #               #         # #
# # # ### ####### # # ###R##### # # ##### #########
# # #   #   #     # # #     #   # #       #       #
# ### # # # # ####### #     # # ##### ####### ### #
# # # # # # #   # #   G  S  # # #     # # # #   # #
# # # # # ##### # # ###     # ### ##### # # # #####
# # # # # #   #   # # #     #   # #     #         #
# # # # ### ### ### # ######### # # ### # # # # # #
#     # #   # #   # #   # #     #     #   # # # # #
# # ##### ### ##### ### # ####### ########### ### #
# # # #   #     #     # # # #     # # # # #     # #
# ### ### ##### # # # ### # ####### # # # # #######
# # # #         # # # #       # #           #     #
# # # ### # # ### ########### # ####### # # # #####
# #   # # # #   # # #   #   #   #       # # #   # #
# # # # ### ##### # ### ### # # ### ### # # ### # #
# # #   # # # # # #   # #     # #   # # # #       #
# # ##### # # # # ### # ####### ##### # # ##### ###
# # #   #   # #   # #     #     #       # # #     #
### # ### ### # # # # ### ### # # ### ### # # ### #
#     #         # #     # # # #   #     #   #   # #
##### ### ### ########### # ######### # ### # # # #
#   #     #   # # #         # #     # # # # # # # #
### ##### # ### # ### ### # # # ##### # # ### #####
# #   # # # #   #   # # # #   #       # # #     # #
# # ### ### # # # ##### # ########### # # ### ### #
#     # #   # #     #           #   # # #         #
# ##### # ### ##### # ####### ##### ##### # ### ###
#                 #         #             #   #   #
###################################################
