#######
### ###
       
# # # #
# #   #
# # # #
# # ###
#     #
###n###
#     #
#     #
#     #
#  P  #
#     #
#     #
#######